#S###############
#...............#
#....#..........#
#....#######....#
#....#.....#....#
#....#.....##.###
#..........#....#
##.#########.#..#
#....#.......#..#
#....#.......#..#
#########E#######
